################
#S.............#
#.##########...#
#.#..........#.#
#.#########..#.#
#...........#.##
#...##########.#
#.#............#
#.#########....#
#.............F#
################