######################
#S...................#
#.#######.####.#####.#
#.#.....#.####.#####.#
#.#.###.#..........###
###...#.#.######.###.#
#.###.#.#.#######.##.#
#.....#.##########.#.#
#F####...............#
#......###############
######################