########################################
#S.................###................F#
#.######.###################.#########.#
#.#....#.#.................#.#.......###
#.#.###.#.#########.#####.#.#.#####.#.##
#.#.#...#.#.......#...#.#...#.#...#.#.##
#.#.#.###.#.#####.#.###.#.#####.#.#.#..#
#...#.#...#...#...#...#.......#.#...#.##
#.###.#.###.###.#####.#.#.#####.#####.##
#...#...#...#...#...#.#.#.#...#.#.....##
#.#.#.#.#.#.#####.#.#.#.#.###.#.#####.##
#.#.#.#.#.#...#...#...#...#.#...#...#.##
#.#.#.#.#.###.#.#########.#.#######.#.##
#...#.#.#...#...#.#...#.#.#...#...#.#.##
#.###.#.###.#####.#.#.#.#.#####.#.#.#.##
#.#.....#...#.....#.#...#.......#...#.##
#.#######.#########.#.###############.##
#...............................#......#
########################################