#########################################################################################################################
#S....#.......#.....................#.......#...#.#.#.....#.#.......#...#...#.....#.#...#.........#.#.............#...#.#
#####.#.###.#.#####.###.#.###########.###.###.#.#.#.###.###.#####.#.#.###.#####.###.#.###.#.#.#####.#.#######.###.#.#.#.#
#.....#.#...#.#.#.#.#...#.#.#.#...#...#.......#.........#.....#...#.#...#...#.#.........#.#.#.#.......#.#...#.#.#...#.#.#
#.#.#########.#.#.#.###.#.#.#.#.###.#.#####.###.#######.#.###.#.#.#####.###.#.###.#####.#.#.#####.#.###.###.###.#.###.#.#
#.#.................#...#.#.#.....#.#.....#.#...#.....#...#...#.#...#.........#.....#...#.#.......#.#...#...........#...#
#.#####.#.###.###.#########.#####.#####.###########.###.#####.#.###.###.#.#.###########.###############.#.#.#.#####.#.###
#...#.#.#.#.#...#...#.#.....#.#...#.....#.....#.#...#.#...#.....#.#.....#.#...#.#.#...#...#.....#.....#...#.#.....#.#...#
###.#.###.#.#####.#.#.###.#.#.###.#.#.#####.###.###.#.#######.###.#.###########.#.#.#.#.#######.#.###.#.#####.#####.###.#
#...#.........#...#.....#.#.#...#.#.#.#.#.....#...#...#...........#.........#.....#.#.......#.....#.........#.....#...#.#
#####################.#.###.#.###.#.#.#.###.#.#.#####.#.###########.#.#.###.#.#.#.#.#####.#####.#####.###.###.#.#######.#
#.......#.......#.....#.#...#.#.#...#.#.....#.#.........#...........#.#.#...#.#.#.#...#.....#.....#...#.#.#...#.#.....#.#
###.#########.###.#.#.#.###.#.#.###.#####.###########.#######.###.###.###########.#.###.#######.#####.#.#.#.###.###.###.#
#.....#...#...#.#.#.#.#...#.#.......#...#.#...#.....#...#...#.#...#...#.....#.....#.#.#...........#...#...#...#.#.......#
#####.#.#####.#.#####.#.###.###.###.#.#.#.###.#.###.#.#.#.#######.###.#.#########.###.#.#######.###.#####.#######.#####.#
#.........#...#.....#.#...#...#.#.....#.......#.#...#.#...#.........#.#.....#.......#...#...#.....#.#...#.#.....#.....#.#
###.#########.#.#########.###.#.###########.###.###.#.#####.#.#############.#.#########.###.#######.#.###.###.#########.#
#.....#.......#.#.#.#...#.#.#...#.#...#.....#.#.#.....#.#.#.#...#.....#.#.#.....#.....#.#.....#.....#.#.....#.....#...#.#
#####.#######.#.#.#.###.#.#.###.#.#.#####.###.#####.###.#.#####.#.###.#.#.#.#.###.#########.#.#####.#.###.#######.#.#.###
#.......#.#.#.....#...#.#...........#...#...#...#.....#.....#.#...#.........#...#.#.#.#...#.#.....#.#...#...#.#.#...#...#
#####.###.#.#.###.#.#.#.#.###.#.#.###.#####.###.#.###.#.#.###.#.#######.#########.#.#.###.###.###.#.#.#.#.###.#.###.###.#
#.......#.#...#.#...#.#...#...#.#.....#.#.....#...#...#.#.#...........#.#.#.....#...#...#.#.#...#...#.#.......#...#...#.#
###.#.###.#.#.#.#####.#.#.###.#####.###.###.#######.###.###.#.#.###.#####.###.#.#.#.###.#.#.#.###.###.#####.###.#####.###
#.#.#.....#.#...#.#.....#.#.#.....#.#.....#.#...#.#...#...#.#.#.#.......#.....#...#.#.#.......#.....#...#...........#...#
#.#####.#####.###.#.#######.#####.###.#.#######.#.#####.#######.#.#.###.#.###.#######.###.###.#.###.#.###.###.#######.###
#.....#.......#...#.........#.#.#...#.#...#.#.#...#...........#.#.#...#.#.#...#...#.#.....#.#.#.#...#...#...#.......#...#
###.#####.#.#####.#########.#.#.#.#.#.#.###.#.###.###.#.#.#.#########.###.###.#.###.#.###.#.#.###.#.#########.#.#####.###
#...#.#...#.#...........#.....#...#...#...#.#.........#.#.#...#.#.#...#.#...#.#.....#.#...#.....#.#.#.........#.#...#...#
#.###.#####.###########.#####.#.#.#######.#.###.###.#####.#.#.#.#.###.#.###.#######.#####.###.###.###.###.#.###.###.###.#
#...#.#.......#.........#.....#.#.#...#.#...#...#.#.#.....#.#...#.#...........#...#...#.....#.#.....#.#...#...#.....#...#
#.#.#.###.#.#######.#####.#######.#.###.#########.#######.#.###.#.#.#.###.#.#####.###.#######.###########.###.#####.###.#
#.#.....#.#...#.#.....#.#.#.#.......#.#...#.#.#.......#...#.#.....#.#.#...#.#.....#.#.#...#...#.#...#.....#.#.#.....#...#
#.#.#.#.###.#.#.###.###.#.#.#########.###.#.#.###.###########.###########.#####.###.#.#.#.#.###.###.#.#####.#####.#####.#
#.#.#.#.....#...........#...........#.......#...........#.....#.#.....#.........#...#.#.#.#.#.#.#...#.#...#.#.........#.#
###.###.#####.###.###.#####.#######.#####.###.#############.#.#.#####.###.#.###.#.#.#.#.#####.#.#.###.#.###.#.#####.#.#.#
#.#...#...#.....#...#.....#.#...#.....#...#...#.......#.#.#.#.#.......#...#.#.....#.#...#...#.#.....#.#...#.#...#...#...#
#.#######.#########.#.#.#.###.#.###.###.#.#.#.###.#.###.#.#.#.#######.###.#########.###.###.#.###.###.#.###.#######.#.###
#.....#...#...#.#.#.#.#.#.#...#...#.#...#.#.#...#.#.#.#.#...#.......#.#.#.#.#.#...#...#...#...#.....#...#...#.#.#.#.#...#
###.###.#####.#.#.#######.#######.#.#.#.#.#.#####.###.#.###.#####.###.#.#.#.#.#.#.#.#.#.###.#.#.#.#####.###.#.#.#.#.#####
#...................#.....#.....#.....#.#...........#.#.#.#...#.....#...#.#.....#.#.#...#...#.#.#...#...#...#.........#.#
#.#########.#.#######.#####.#####.###.#.#####.#.###.#.#.#.#.#######.#.#######.#########.#.###.#.#.###.###.#.#.#####.###.#
#.....#.#...#.....#.....#...#.....#.#.#...#...#.#...#...#.#.#.#.......#.....#.#...#...#.....#...#.#...#...#.#.#...#.....#
#.#####.#######.#.#####.#.###.#####.#######.###.#.#.#.###.###.###.#######.###.#.#.#.#########.#.#.#.#.#.#########.###.#.#
#...#.#.#...#.#.#.#...#.#...#.....#.....#...#...#.#...#.....#.#.......#.....#...#...#.#.#...#.#.#.#.#...........#...#.#.#
#.###.#.#.###.#.#####.#.#.###.#.#####.###.#####.#.#.#.#####.#.#.#.#.#.#####.#######.#.#.###.###.###.###############.###.#
#.#.......#.....#...#.#...#...#.#...#.....#.....#.#.#.....#.#.#.#.#.#...............#.....#...#.#.....#.............#.#.#
#####.#.###.###.#.###.###.#########.#############.#.###.#.#.#.#.#########.#.###.#######.###.#.#.#.###.###.#########.#.#.#
#.....#.......#.#...#.......#...#.#.#...#...#...#.#...#.#...#.#.#.....#...#.#.........#...#.#...#.#.#...#...#.#.........#
###.#####.###.#####.#.#######.###.#.###.#.###.#.#.###########.#####.#.###.#######.#######.###.#####.###.###.#.###.#####.#
#.#.#...#...#...#.#...........#...#.#.....#...#.#...#.......#...#...#.#.........#...#...........#.....#...#...#.#.#.#...#
#.###.#.#########.#####.#######.###.###.###.###.#.#######.###.###.###.#####.#############.#.#######.#######.###.###.###.#
#...#.#.......#.......#...#...#.#.....#.....#.........#.........#...#.#.#.......#.#.#.#...#.#...#.....#...............#.#
#.#######.#####.###.#####.###.#.#.#.###############.#.###.###.#####.###.#.#####.#.#.#.#.#######.#.###.#####.#####.###.#.#
#...............#...#...#.#...#.#.#...#...#...#...#.#.....#.....#.......#.....#.....#...#...#.#.#...#.........#...#.#.#.#
#####.###.#########.###.#.###.#.#.#.#####.###.###.###.#######.#######.#.#####.#.###.#.###.###.#.#.#######.#.#####.#.###.#
#...#.#...#.#...#.#...#.....#.#.#.#...#...#.....#...#.#.#...#.#.#.....#...#...#...#.....#.......#.....#...#.....#.....#.#
#.###.#####.#.#.#.#.#.#.#####.#.###.#.#.#####.#.#.###.#.#.#####.#.###.#####.###.#.#.#.#.#.###.#.#.#.###.###########.###.#
#.#...#.#.....#.#...#.#...#...#.....#.........#...#.....#.....#...#.....#.#.#...#.#.#.#...#...#...#...#.#.....#...#...#.#
#.#####.#.#######.#.###.#####.#######.#.###.###.#.#####.#.###.###.#.#.###.#########.#####.###.#####.#.#.#####.###.#####.#
#.....#.........#.#.....#.......#.#...#...#.#.#.#...........#.#...#.#.........#.........#.#...#...#.#.#.#.#.....#...#.#.#
#.#.#.#.###.#####.###.#.###.###.#.#####.###.#.#.#######.#####.#####.#####.###.#####.#########.#.#.###.###.#####.#.###.#.#
#.#.#.#.#.....#...#.#.#.....#.......#.....#.#.......#...#.#...#.....#.......#.#...#.....#...#.#.#.......#.#...#...#...#.#
#.#.#####.#.###.#.#.#####.#######.###.###.#####.#####.###.#####.#.###.#.#########.#.###.#.#.#.#.#####.###.###.###.#.#####
#.#.#.....#...#.#...#.#...#.#.#.....#.#.#...#...#.......#.......#.#...#.#...........#.#.#.#...#...#.#.....#.....#.#...#.#
#.#.#.###############.###.#.#.#.#######.#.###########.###.#####.###.###.#####.#######.#####.#.#.#.#.#.#.###.#.###.#.###.#
#.#...........#.#.#.#.....#.............#.....#...#...#.#.#.......#.#.....#.#.#...#...#...#.#.#.#.#...#.....#.......#...#
#########.#.#.#.#.#.###.#####.#########.###.#.###.#####.#.###########.#.#.#.#.###.###.#.#########.#####.#########.###.###
#.....#...#.#.....#.#...#...#.......#.#.#.#.#.#.....#...#.#.#.....#...#.#...#.#...#.......#.#.........#.........#.#.....#
#.#.#.#.#.###.###.#.###.#.###.###.###.###.###.#.#.#####.#.#.#.#####.###.###.#.#.#####.#####.#######.#.#########.#.#.#.###
#.#.#...#...#.#.............#...#.......#.......#...#.....#...........#.#...............#...........#.......#...#...#..F#
#########################################################################################################################