#################################################################################
#S..#...#...#...#.#...#...#.........#.#.#.#...........#...#...#.....#...#.......#
###.#.#####.#.###.#.#.#.#.#####.#.###.#.#.#.#####.###.###.###.#.###.###.#.###.#.#
#.#...#...........#.#...#.#...#.#.......#.#.#.....#.......#.....#...#.......#.#.#
#.###.###.#.###.###.#.#######.#.###.#.###.#.###.#.###.#########.#####.#.###.###.#
#...#.#...#.#.#.....#.#.........#...#...#...#...#...#.#.......#.#...#.#.#...#...#
#.###.###.###.#.#.###.#.#######.#####.#.#.###.#.#########.#####.#.#############.#
#.....#.......#.#...#.#...#.......#...#.#.#...#.#.#.#.....#.......#.....#.....#.#
#.#.#########.###.###########.###.#######.###.#.#.#.#####.#.#####.#####.#####.#.#
#.#.#...........#.#.#.#.#.......#.....#.....#.#.#.......#.......#.#.#...#...#...#
###.###.#####.#.###.#.#.#.#####.#.#######.#########.#.#.#######.#.#.#.#.###.#.#.#
#.........#.#.#.#.#.#.#.#...#.#.#.#...#.....#.#.#...#.#...#.#...#.#...#.#.#...#.#
#.#######.#.###.#.#.#.#.#.###.#######.#.###.#.#.###.#.#####.###.#.#.#####.#####.#
#.#.#...#...#...............#...#.....#.#.#.....#...#...........#...#...........#
###.#.#.#####.#####.#######.###.#.#.#.#.#.#.#.#######.###.#######.#.###.#.#.#.#.#
#...#.#.#.#.#.#.#...#.#...#...#...#.#...#...#.....#...#.#.#.#.#...#.#...#.#.#.#.#
#.###.###.#.###.#####.###.#.###.###.#####.#######.#.###.#.#.#.#.#####.#####.#.#.#
#.....#...#.....#...............#.....#.........#.......#.....#...#.#...#...#.#.#
#.#.#.#.#.#.#.#######.#.###################.#.#######.#####.#####.#.#.#######.###
#.#.#...#.#.#.#.....#.#.....#.#.............#.#.....#...#.#.#.....#.....#.......#
###.#######.#.###.#.#.###.###.#.#####.#######.###.#.#####.###.###.###.#########.#
#...#.#.....#.....#...#...#.#.#.#.#...#...#.#.....#.......#.#.#.#.#.......#...#.#
#.#.#.#.#######.#.###.#.#.#.#.###.#.#.###.#.#.###########.#.#.#.#.###.###.###.#.#
#.#...#.#.....#.#.#...#.#.#...#.#.#.#.......#.........#.....#.#.#...#...#...#.#.#
#.#####.#.###.#######.###.#.###.#.#.#######.#.#############.#.#.#.###.#.#.###.###
#.#.#...#.#.#.#...#.#.#.#.#.#.........#...#.#.....#...#.#...#.#.#.#...#.#.......#
#.#.#.###.#.#####.#.###.###.###.###.###.###.#######.#.#.###.###.#.#####.#####.###
#...#...#...#.#.......#.#.#.......#...#...#.#.#...#.#.......#.....#...#.....#...#
###.#.#####.#.#######.#.#.###.###.#.###.#.###.#.#####.#.#######.###.#######.#####
#...#.#.#...#.#.#.....#.........#.#.....#.#...#.......#.#.#.#.....#...#.#...#...#
###.#.#.#.###.#.###.#.#.#####.#.#####.#.#.###.#########.#.#.#.#.#.#.#.#.###.#.###
#.#.#.......#...#.#.#...#.#...#.#...#.#.#.#.#.....#.#.#.....#.#.#.#.#...#...#...#
#.#.#.###.###.###.###.###.###.#.#.#########.#.#.###.#.#######.#####.#####.#####.#
#.......#...#.....#.#...#...#.#.......#...#...#.....#.#.#...#.#.#.#.....#.#...#.#
#####.###########.#.###.###.#####.#.#.#.#.#######.#.#.#.###.#.#.#.#.###.#.#.###.#
#.........#...#.........#.#.#.#...#.#.#.#.#.#.....#...#.#.....#.....#...........#
#.###.#######.###.#.#.###.#.#.#.#.#.###.#.#.#######.###.###.###########.#######.#
#.#.....#.#...#...#.#...#.#.#...#.#.....#.....#...........#.#.....#.......#.....#
###.###.#.###.###.#.#.#.#.#.#######.#####.#####.###.#.###.#.#.###.#.#.###.#.#####
#.....#...#.......#.#.#.#...........#.....#.......#.#.#.......#.....#.#...#....F#
#################################################################################